en_US|en_US|zh_CN
worldExplorer|World Explorer|事物管理器
World|World|世界
Project|Project|项目
Plugin|Plugin|插件
ChildWorld|ChildWorld|子世界
menuFile|File|文件
menuItemOpenThing|Open Thing|打开事物
menuItemOpenAction|Open Action|打开动作
menuItemSave|Save|保存
menuItemExit|Exit|退出
menuTool|Tool|工具
menuItemTaskManager|Task Manager|任务管理器
menuItemStartJetty|Start|启动
menuItemStopJetty|Stop|关闭
menuItemLanguage|Language|语言
menuItemLangZHCN|简体中文|简体中文
menuItemLangENUS|English(US)|English(US)
menuDebug|Debug|调试
menuItemEnableDebug|Enable Debug|启动调试
menuHelp|Help|帮助
menuItemHelpContent|Help Content|帮助内容
menuItemAbout|About|关于
menuItemReinit|Reinit World Explorer|重新初始化事物管理器
toolBarItemOpenThing|Open Thing|打开事物
toolBarItemSave|Save Thing|保存事物
projectNavTree|Projects|项目导航
functionNavTab|Functions|功能
commonBoxTitle|Operate Info|操作信息
thingNotExists|Thing not Exists:|事物不存在：
thingEditorNotExists|Thing Editor not Exists:|事物编辑器不存在：
menuItemRefresh|Refresh|刷新
centerTabClose|Close|关闭
centerTabCloseOther|Close Others|关闭其他
centerTabCloseAll|Close All|关闭所有
outlineNavTab|Outline|概要
addChildsTab|Add Child Thing|添加子事物
consoleTab|Console|控制台
thingFlowMonitorTab|Thing Flow Monitor|事物流程监控
name|Name|名称
label|Label|标签
path|Path|路径
pathLabel|Path:|路径：
descriptorLabel|Descritpor:|描述：
childLabel|Child Things:|子事物：
descriptor|Descritpor|描述者
lastUpdateDate|Last Updated Date|最后修改日期
run|Run|运行
running|Running|正在运行
thingFlowDefinitiong|Thing Flow definition|流程定义
stopThingFlow|Stop Thing Flow|结束流程
terminateThingFlow|Terminate Thing Flow|终止流程
status|Status|状态
cancelThingFlowThread|Cancel Thread|取消线程
cancel|Cancel|取消
terminateThingFlowThread|Terminate Thread|终止线程
refresh|Refresh|刷新
refreshAll|Refesh all|刷新所有
thingFlowRequest|Thing Flow Requests|事物流程请求
thingFlowRequestTip|Rquests is created for UI to handle|事物流程执行时发出的用户处理请求。
priority|Priority|优先级
thingFlowPath|Thing Flow Path|流程路径
editRequest|Edit Request|编辑请求
cancelRequest|Cancel Request|取消请求
categoryViewer|Category Viewer|目录浏览
askCancelRequsetHandle|Previous Request is not finished. Cancel it?|原先的请求还未处理完毕，要放弃原先的请求而处理新的请求吗？
askCancelThingEdit|Thing is changed, cancel changes?|事物已更改，是否要保存当前事物？
copyPath|Copy Path to Clipboard|拷贝路径
moveUpNode|Move up Node|节点上移
moveDownNode|Move down Node|节点下移
delete|delete|删除
searchAndReplace|Search & replace|查找替换
replaceLabel|Replace:|替换：
up|Up|向上
down|Down|向下
searchAndReplaceButton|Search & Replace|替换/查找
search|Search|查找
replace|Replace|替换
replaceAllButton|Replace All|替换所有
findlabel|Search:|查找：
searchDir|Search Direction|查找方向
assit|Assits|辅助
cut|Cut|剪切
copy|Copy|复制
paste|Paste|粘贴
pasetAsChild|Paste as child|粘贴－当作子节点
edit|Edit|编辑
editLabel|Edit:|编辑：
changeEditMode|Change edit mode|改变编辑模式
addDescriptor|Add descriptor|添加描述
deleteDescriptor|Delete descriptor|删除描述
confirmDeleteDescriptor|Are you sure to delete the selected descriptor?|确实要删除选中的描述么？
askDeleteNode|Are you sure to delete the node|确定要删除选中的节点吗？
removeDescriptorAndChild|Delete descriptor and it's childs|删除描述及其子事物
addExtend|Add extend|添加继承
deleteExtend|Delete extend|删除继承
addLabel|Add:|添加
askDeleteExtend|Are you sure to delete the selected extend?|确实要删除选中继承么？
runBackGroun|Run in background|后台运行
askDeleteAllThing|Are you sure  to delete the root Thing|确实要删除整个事物么？
viewDescriptorAndExtend|View descriptors and extends|浏览描述和继承
descritorAndExtend|Descriptor and extend|描述和继承
allDescriptrsLabel|All descritpors|所有描述：
allExtends|All extends|所有继承：
openButton| Open(&O) | 打开（&O） 
extButton| Exit(&X) | 退出（&X） 
okButton| Ok(&O) | 确定（&O） 
cancelButton| Cancel(&C) | 取消（&C） 
editThingId|Edit thing id|编辑事物标识
thingLabelId|Thing id:|事物标识：
fastLocate|Search and replace|快速定位
searchLabel|Search:|查找：
searchButton| Search(&F) | 查找（&F） 
node|Node|节点
attributeName|Attribute name|属性名
value|Value|值
groovyConsole|Groovy Console|Groovy脚本控制台
runButton| Run(&R) | 执行(&R) 
thingHistoryLsit|History|事物历史列表
restoreButton| Restore(&R) | 恢复 (&R) 
askRestorHistoryThing|Are you sure to restore the selected history thing?|确实要恢复到历史事物么?
newCategory|New Category|新建目录
categoryLabel|Category name|目录名：
alertCategoryExists|Same category already exists!|目录已经存在！
newProject|New Project|新建项目
projectNameLabel|Project name:|项目名称：
alertProjectExists|Proejct already exists!|项目已经存在！
newThing|New Thing|新建事物
thingNameLabel|Thing Name:|事物名：
descriptorNameLabel|Descritpor:|描述：
oldUsedDescriptorLsit|Old descritpors have used|以往所使用的描述者列表：
lastVisitTime|Last visit|最后访问
visitCount|Visit count|访问次数
alertThingExists|Thing already exists!|事物已经已经存在！
newThingManager|New ThingManager|新建事物管理器
thingManagerNameLabel|ThingManager name:|事物管理者名称：
alertThingManagerExists|ThingManager already exists|事物管理器已经存在！
assitLabel|Assit:|辅助：
applyButton| Apply(&A) | 应用（&A） 
editButton| Edit(&E) | 编辑（&E） 
editExampleButton| Edit example | 编辑示例 
closeButton| Close（&C） | 关闭（&C） 
template|tempalte|模板
guide|Guide|向导
example|Example|示例
note|Note|笔记
document|Document|文档
openThing|Open Thing|打开事物
alertActionNotExists|Action not exists!|动作不存在!
alertThingNotExists|Thing not exists!|事物不存在!
message|Message|消息
thingGuide|Thing Guide|事物向导
thingToXmlTitle|Thing to XmL - only for reference|事物XML-仅供参考
convertTohtmlButton|Convert to HTML(&H)|转换到HTML（&H）
importEditXml|Editr & Import XML|编辑导入XML
importButton| Import(&I) | 导入（&I） 
moveToPreNodeLink|<a>Move to pre Node</a>|<a>移动至上一节点</a>
moveToNextNode|<a>Move to next Node</a>|<a>移动至下一节点</a>
pasteLink|<a>Paste</a>|<a>粘贴</a>
pasteAsChildLink|<a>Paste As Child</a>|<a>粘贴当作子节点</a>
moveAndPasteLink|<a>Move and Paste</a>|<a>移动粘贴</a>
moveAndPasteAsChildLink|<a>Move adn Paste as Child</a>|<a>移动粘贴当作子节点</a>
cancelLink|<a>Cancel</a>|<a>取消</a>
import|Import|导入
importFromDtd|Import from DTD|导入DTD
deleteCategory|Delete Category|删除目录
homePage|Home|主页
back|Back|后退
forward|Forward|前进
stop|Stop|停止
htmlEditor|HTML Editor|HTML编辑器
baseAttribute|BaseAttrs|基础属性
refreshControl|Refresh Control|刷新控件
refreshParentControl|Refresh parent Control|刷新父控件
refreshChildControl|Refresh child Control|刷新子控件
performanceViewer|Performance Viewer|性能浏览器
actionPath|Action Path|动作路径
totalRunCount|Total Run Count|运行次数
totalTime|Total Time|总耗时
averageTime|Average Time|平均耗时
successCount|Successed Count|成功次数
failuredCount|Failured Count|失败次数
showAllActions|Show All Actions|显示所有动作
reset|Reset|重置
openAction|Open Action|打开动作